1111111111111111111111111111
1000000000110000000000001
1011000001110000000000001
1001000000000000000000001
1111111110110000011100001
10000000001100000111011111111
11110111111111011100000010001
11110111111 11011101010010001
11000000110101011100000010001
10000000000000001100N00000001
10000000000000001100000010001
10000000000000001101010010001
11000001110101011111010110001
11110111111101011101111010001
11111111111111111111111111111